9999999999999999
0111111111111110
0111111111111110
0111111111111110
0111111111111100
0111111111111110
0111111111111110
0111111111111110
0111111111111110
0111111111111110
0111111111111110
0111000000011110
0111111111111110
0011111111111100
0000000000000000
0000000000000000